NO ./textures/8/north.xpm
SO ./textures/8/south.xpm
WE ./textures/8/west.xpm
EA ./textures/8/east.xpm

F 180,211,180
C 135,206,235

11111111111111111111111111111111111111111111111111111111111111111111111111111111
10000000001110000000000000000001111111000000000000000000000000000000000000000001
1FFFFFFFFFFFFFFFFFFFFFFFFFFFFFFFFFFFFFFFFFFFFFFFFFFFFFF0000000000000000000000001
1FFFFFFFFFFFFFFFFFFFFFFFFFFFFFFFFFFFFFFFFFFFFFFFFFFFFFF0000C00000000000000000001
1FKFFFFFFFFFFFFFFFFFFFFFFFFFFFFFFFFFFFFFFFFFFFFFFFF000000K0000000000000000000E01
1FFFFFFFFFFFFFFFFFFFFFFFFFFFFFFFFFFFFFFFFFFFFFFFFFFFFFF0000C00000000000000000001
10000000000000000000000000000000000000000000000000000000000000000000000000000001
11111111111111111111111111111111111111111111111111111111111111111111111111111111